term	kind
data	political
artificial intelligence sector	political
clean growth	political
brexit	political
mobility	political
data-driven technologies:	political
data science	political
computer science	political
automotive	political
genomics	political
automation artificial	political
life sciences	political
vehicles	political
stem	political
broadband	political
public	political
ai	political
fair work	political
strategy	political
development	political
data protection	political
budget resolutions	political
vehicle	political
public services	political
digital connectivity	political
social care	political
ethics	political
innovation	political
and	political
business energy and industrial strategy]	political
data-driven innovation	political
data protection regulation	political
digital strategy	political
data protection bill	political
computer	political
long-term	political
science	political
digital	political
care	political
automation	political
mental health	political
digital diagnostics	political
autonomous vehicles	political
energy	political
automated and electric vehicles	political
change	political
information technology	political
it	political
investment bank	political
internet	political
industrial	political
manufacturing	political
creative industries	political
infrastructure	political
social mobility	political
industrial strategy	political
digital economy	political
digital infrastructure	political
business energy	political
algorithms	political
healthcare	political
investment	political
artificial intelligence big	political
renewable energy	political
economy	political
ai strategy	political
life	political
robotics	political
health and social care	political
technology	political
insurance	political
driverless cars	political
engineering	political
ai technology	political
cars	political
electric vehicles	political
diagnosis	political
transparency	political
data ethics	political
ai systems	political
robots	political
financial	political
r	political
education	political
maths	political
health	political
law	political
tech	political
human	political
big data	political
construction	political
digital technologies	political
digital technology	political
transport	political
5g	political
health service	political
budget	political
climate change	political
machine learning	political
social care]	political
car	political
digital skills	political
retraining	political
framework	political
data-driven technologies	political
AI Deep	reddit
Federated Learning	reddit
AWS	reddit
language models	reddit
Data	reddit
Go	reddit
machine learning algorithms	reddit
PHD	reddit
AI Model	reddit
Discord server	reddit
natural language processing	reddit
Python library	reddit
Computer Vision	reddit
OpenAI’s GPT-3	reddit
open	reddit
video	reddit
chatbots	reddit
classifier	reddit
intelligence?	reddit
Mathematics	reddit
ai	reddit
sentiment analysis	reddit
ML frameworks	reddit
logic	reddit
chess	reddit
distance	reddit
consciousness	reddit
computer vision	reddit
brain	reddit
Marketing	reddit
AI ML	reddit
business	reddit
ANNs	reddit
image classification	reddit
Python Library	reddit
artificial intelligence deep	reddit
AI Masters	reddit
AI implementation	reddit
Singularity	reddit
pixels	reddit
backpropagation	reddit
Finance	reddit
segmentation	reddit
genetic algorithms	reddit
cryptocurrency	reddit
linear regression	reddit
Intelligence:	reddit
classification	reddit
evolution	reddit
precisionFDA	reddit
tasks	reddit
autonomous vehicles	reddit
hyperparameters	reddit
detection	reddit
music	reddit
Strong AI	reddit
facial recognition	reddit
voice assistants	reddit
Facebook AI	reddit
Natural Language Processing (NLP)	reddit
sadness	reddit
AIs	reddit
heuristics	reddit
Monte Carlo	reddit
programming	reddit
AI tool	reddit
AI research?	reddit
common sense	reddit
sentient	reddit
game-changer	reddit
cancer	reddit
game	reddit
Automation	reddit
Deepmind	reddit
natural language processing (NLP)	reddit
Deep Learning	reddit
NLP	reddit
self-driving cars	reddit
healthcare	reddit
philosophy	reddit
artificial Intelligence	reddit
finance	reddit
app	reddit
Machine learning	reddit
GPU	reddit
artificial neural networks	reddit
templates	reddit
RL agents	reddit
RPA	reddit
intelligence	reddit
general intelligence	reddit
similarity	reddit
RSIP Vision:	reddit
biology	reddit
transformers	reddit
back propagation	reddit
Deep Learning models	reddit
It	reddit
GPT-J	reddit
layers	reddit
statistics	reddit
AI ethics	reddit
rules	reddit
DL	reddit
reinforcement learning	reddit
AI R&amp;D	reddit
real estate	reddit
AI projects	reddit
maths	reddit
medicine	reddit
vision	reddit
Machine Learning	reddit
Computer Science	reddit
problem solving	reddit
AI program	reddit
artificial intelligence (AI)	reddit
human	reddit
generative model	reddit
GPT-3	reddit
AI programs	reddit
neural networks?	reddit
Artificial General Intelligence (AGI)	reddit
machine learning)	reddit
self driving cars	reddit
Google AI	reddit
AI models	reddit
code	reddit
artificial intelligence:	reddit
R&amp;D	reddit
games	reddit
Programming	reddit
Machine Learning Models	reddit
memory	reddit
apps	reddit
blockchain	reddit
data	reddit
"AI"""	reddit
Alexa	reddit
conversational AI	reddit
Artificial Intelligence:	reddit
Facebook	reddit
computer vision tasks	reddit
generative models	reddit
real-world applications	reddit
AI's	reddit
DALL-E	reddit
agriculture	reddit
AI algorithm	reddit
object	reddit
Math	reddit
algorithm	reddit
expert systems	reddit
ELI5	reddit
development	reddit
Data Science	reddit
AI/machine learning	reddit
GPT-3?	reddit
calculus	reddit
COVID-19	reddit
Keras	reddit
Meta AI	reddit
ANN	reddit
StyleGAN	reddit
of	reddit
learning	reddit
objects	reddit
computational neuroscience	reddit
Security	reddit
prediction	reddit
AI Tool	reddit
singularity	reddit
robot	reddit
decision tree	reddit
GNNs	reddit
strong AI	reddit
chatbot?	reddit
computer	reddit
JS	reddit
data collection	reddit
virtual	reddit
optimization	reddit
neural networks	reddit
deepfakes	reddit
IT	reddit
faces	reddit
discord server	reddit
overfitting	reddit
Transfer Learning	reddit
ontologies	reddit
python	reddit
Chatbot	reddit
AI techniques	reddit
planning	reddit
Superintelligence	reddit
evolutionary computation	reddit
AI applications	reddit
security	reddit
RL	reddit
CNN	reddit
supercomputer	reddit
R	reddit
Physics	reddit
artifical intelligence	reddit
AR	reddit
Reinforcement Learning	reddit
Robotics	reddit
Computer Vision News	reddit
Mask R-CNN	reddit
cars	reddit
web	reddit
AI safety	reddit
AI technology	reddit
analysis	reddit
ML models	reddit
PyTorch	reddit
Modern Approach	reddit
Artificial intelligence	reddit
AI software	reddit
BERT	reddit
graphic design	reddit
time	reddit
deep learning	reddit
edges	reddit
AI model	reddit
decision trees	reddit
education	reddit
AI technologies	reddit
LinkedIn	reddit
tensorflow	reddit
latent space	reddit
Chatbots	reddit
AI?	reddit
coronavirus	reddit
image generation	reddit
Healthcare	reddit
AGI?	reddit
DNN	reddit
IoT	reddit
theory	reddit
UI	reddit
self-attention	reddit
reasoning	reddit
neuroscience	reddit
NN	reddit
Computer Engineering	reddit
AI agents	reddit
design	reddit
math	reddit
abstraction	reddit
deep neural networks	reddit
bias	reddit
AI programming	reddit
computation	reddit
Approach	reddit
CS	reddit
systems	reddit
artificial intelligence technology	reddit
They	reddit
knowledge	reddit
mind	reddit
Multimodal Emotion Recognition Competition	reddit
gaming	reddit
optimization algorithms	reddit
genetic algorithm	reddit
technological singularity	reddit
hardware	reddit
images	reddit
Siri	reddit
object detection	reddit
TensorFlow	reddit
data science	reddit
ML?	reddit
computer science	reddit
creativity	reddit
Ai	reddit
model	reddit
machine learning (ML)	reddit
Transformer	reddit
world	reddit
Artificial Intelligence?	reddit
deep fakes	reddit
GAN	reddit
public	reddit
computing	reddit
3D	reddit
privacy	reddit
Cognitive Science	reddit
prior knowledge	reddit
Transformers	reddit
machine learning deep	reddit
superintelligence	reddit
supervised learning	reddit
AI:	reddit
bots	reddit
stack overflow!	reddit
animation	reddit
ethics	reddit
GPT-4	reddit
AI research	reddit
AI robots	reddit
Genetic Algorithms	reddit
Machine Translation	reddit
Deep Learning Computer	reddit
scenarios	reddit
light	reddit
GPT-2	reddit
electrical engineering	reddit
artificial general intelligence	reddit
machine learning model	reddit
AIMA	reddit
Github	reddit
VR	reddit
Big Data	reddit
NLP tasks	reddit
speaker verification	reddit
virtual reality	reddit
computer program	reddit
CLIP	reddit
inference	reddit
Neural Networks	reddit
programming language	reddit
network	reddit
cutting-edge	reddit
it	reddit
physics	reddit
API	reddit
textures	reddit
super intelligence	reddit
Tensorflow	reddit
language	reddit
sentient AI	reddit
3D models	reddit
CNNs	reddit
python?	reddit
Turing test	reddit
neural nets	reddit
frameworks	reddit
machine learning models	reddit
OpenAI	reddit
transfer learning	reddit
technology	reddit
video games	reddit
software development	reddit
chatbot	reddit
language model	reddit
A.I	reddit
Convolutional Neural Networks	reddit
AlphaZero	reddit
Artificial Neural Networks	reddit
diagnosis	reddit
podcasting	reddit
few-shot learning	reddit
AI)	reddit
recommender systems	reddit
RL algorithms	reddit
C	reddit
robots	reddit
training	reddit
Java	reddit
computer vision artificial	reddit
Transformer architecture	reddit
quantum computing	reddit
superintelligent AI	reddit
GANs	reddit
Learning	reddit
AGI	reddit
C#	reddit
image recognition	reddit
Conversational AI	reddit
videos	reddit
NLG	reddit
human intelligence	reddit
Artificial Intelligence	reddit
Google AI Introduces	reddit
ML model	reddit
Python	reddit
DeepSpeed	reddit
patterns	reddit
Neural Network	reddit
ML/AI	reddit
Algorithms	reddit
climate change	reddit
Deep learning	reddit
SOTA	reddit
AI algorithms	reddit
mathematics	reddit
economics	reddit
heuristic	reddit
AI engine	reddit
machine learning?	reddit
Natural Language Processing	reddit
artificial intelligence	reddit
Artificial General Intelligence	reddit
emotion	reddit
pretrained models	reddit
deep learning?	reddit
coding	reddit
visualization	reddit
Education	reddit
emotion recognition	reddit
NLP?	reddit
IA	reddit
Artificial Intelligence (AI)	reddit
weights	reddit
deep learning model	reddit
Neural networks	reddit
data mining	reddit
search	reddit
TPUs	reddit
uncertainty	reddit
features	reddit
GPUs	reddit
programming languages	reddit
they	reddit
AI tools	reddit
ASI	reddit
Language Models	reddit
RNN	reddit
ML	reddit
StarCraft	reddit
Computer	reddit
web development	reddit
speech recognition	reddit
general AI	reddit
pattern recognition	reddit
NLP models	reddit
Neuroscience	reddit
software engineering	reddit
automation	reddit
AI-generated writing	reddit
AI-related	reddit
AlphaGo	reddit
Turing Test	reddit
face recognition	reddit
Detecting Adverse Event Anomalies	reddit
pre-trained models	reddit
AI system	reddit
artificial intelligence?	reddit
software	reddit
neural network	reddit
ByteDance	reddit
communication	reddit
AI systems	reddit
algorithms	reddit
deep learning models	reddit
AI/ML	reddit
DeepMind	reddit
image processing	reddit
AI chatbot	reddit
robotics	reddit
machine learning algorithm	reddit
Google	reddit
AI methods	reddit
computer engineering	reddit
engineering	reddit
marketing	reddit
layer	reddit
neural net	reddit
Maths	reddit
AiBB	reddit
shapes	reddit
computational resources	reddit
OCR	reddit
GPT2	reddit
MCTS	reddit
AI/ML?	reddit
AI development	reddit
tech	reddit
Intelligence	reddit
sensors	reddit
AI solutions	reddit
OpenCV	reddit
machine translation	reddit
C++	reddit
noise	reddit
machine	reddit
history	reddit
CV	reddit
models	reddit
machine learning	reddit
medical	reddit
fine-tuning	reddit
unsupervised learning	reddit
facial expressions	reddit
platform	reddit
deep learning framework	reddit
Machine Learning?	reddit
search space	reddit
medical diagnosis	reddit
policy	reddit
"learning"""	reddit
linear algebra	reddit
Term	reddit
share	consultancy
mobility	consultancy
ai:	consultancy
tv analytics space—bringing	consultancy
asset	consultancy
gamification	consultancy
read more	consultancy
costs	consultancy
economic	consultancy
health insurers	consultancy
predictive algorithms	consultancy
conduct risk	consultancy
natural language processing	consultancy
landscape	consultancy
integration	consultancy
health care	consultancy
revolution	consultancy
b2c	consultancy
strategy leadership	consultancy
fraud	consultancy
semiconductor	consultancy
chatbots	consultancy
e-commerce	consultancy
devices	consultancy
behavior change	consultancy
ai	consultancy
business model	consultancy
business technology	consultancy
upskilling	consultancy
hub	consultancy
business models	consultancy
business	consultancy
automation technology	consultancy
statistical models	consultancy
ideation	consultancy
healthcare system	consultancy
social and business value	consultancy
visibility	consultancy
big data strategy	consultancy
global economy	consultancy
three-step approach	consultancy
claims management	consultancy
auto	consultancy
mining	consultancy
governance model	consultancy
supply chain	consultancy
intelligent enterprise	consultancy
providers	consultancy
digital	consultancy
financial crime	consultancy
digital business models	consultancy
gap	consultancy
tasks	consultancy
autonomous vehicles	consultancy
cyberattack	consultancy
culture	consultancy
private	consultancy
research report	consultancy
automation adoption	consultancy
change	consultancy
artificial intelligence (ai)	consultancy
digital transformation?	consultancy
businesses	consultancy
processes	consultancy
cognitive computing	consultancy
human capital	consultancy
production	consultancy
infrastructure	consultancy
digitally-native	consultancy
technology media and telecommunications (tmt) sector	consultancy
human biases	consultancy
autonomous driving	consultancy
analytics techniques	consultancy
healthcare	consultancy
data and analytics	consultancy
biases	consultancy
leaders identity mindtrap: personal	consultancy
finance	consultancy
economy	consultancy
user-centric approach	consultancy
auditors	consultancy
artificial intelligence leader	consultancy
insurance:	consultancy
pe	consultancy
automotive industry	consultancy
plans	consultancy
kpmg	consultancy
intelligence	consultancy
digital solutions	consultancy
translation	consultancy
cybersecurity	consultancy
digital transformation	consultancy
data-driven approach	consultancy
driver	consultancy
predictive maintenance	consultancy
launches	consultancy
decision making	consultancy
reality	consultancy
ai frontiers	consultancy
integrated approach	consultancy
institute	consultancy
risk management	consultancy
artificial intelligence)	consultancy
plan	consultancy
human	consultancy
hr	consultancy
trust	consultancy
corruption	consultancy
value	consultancy
data architecture	consultancy
talent management	consultancy
annual planning	consultancy
digital players	consultancy
transactional activities	consultancy
business processes	consultancy
procurement	consultancy
machine-learning algorithms	consultancy
physical hazards	consultancy
government	consultancy
corporate	consultancy
asset management	consultancy
artificial intelligence:	consultancy
retraining	consultancy
units	consultancy
analytics	consultancy
blockchain	consultancy
data	consultancy
pricing	consultancy
global wealth & asset management leader	consultancy
asia	consultancy
human connections	consultancy
adoption	consultancy
delivery models	consultancy
incentives	consultancy
short-term	consultancy
audit	consultancy
life sciences	consultancy
finance function	consultancy
stem	consultancy
data governance	consultancy
nlp	consultancy
diversity	consultancy
artificial-intelligence technology	consultancy
ai applications	consultancy
oil and gas industry	consultancy
digital tools	consultancy
strategy	consultancy
insights	consultancy
bcg	consultancy
organizations	consultancy
approaches	consultancy
ai technologies	consultancy
data analytics	consultancy
ai frontier:	consultancy
natural-language processing	consultancy
travel industry	consultancy
of	consultancy
learning	consultancy
advanced robotics	consultancy
financial services industry	consultancy
capgemini	consultancy
internet of things (iot)	consultancy
telcos	consultancy
end-to-end process	consultancy
climate risk	consultancy
blockchain technology	consultancy
intelligent technologies	consultancy
outsourcing	consultancy
gas	consultancy
automation technologies	consultancy
technology infrastructure	consultancy
organizational models	consultancy
aml	consultancy
data-driven decisions	consultancy
assets	consultancy
value chain	consultancy
touchpoints	consultancy
optimization	consultancy
banks	consultancy
neural networks	consultancy
behavioral change	consultancy
attribution	consultancy
sustainability	consultancy
reskilling	consultancy
machine learning (ml)	consultancy
organization	consultancy
underwriting	consultancy
auto industry	consultancy
ai system	consultancy
health system	consultancy
financial services organizations	consultancy
security	consultancy
companies	consultancy
it systems risk management	consultancy
transformation	consultancy
analytical models	consultancy
ia	consultancy
iot sensors	consultancy
tax	consultancy
global challengers	consultancy
automation leader	consultancy
risk	consultancy
cars	consultancy
integrity program structure	consultancy
fintech	consultancy
it systems	consultancy
reduction	consultancy
r&d	consultancy
digital strategies	consultancy
deep learning	consultancy
climate risk and response: physical	consultancy
education	consultancy
healthy aging	consultancy
inclusiveness	consultancy
big data analytics	consultancy
governance	consultancy
roi	consultancy
scheduling	consultancy
digital innovation	consultancy
health sciences and wellness	consultancy
big data	consultancy
products	consultancy
contract analysis	consultancy
reasoning	consultancy
interactions	consultancy
customer service	consultancy
cloud computing	consultancy
rpa	consultancy
operational efficiency	consultancy
scale	consultancy
digital maturity	consultancy
customer journeys	consultancy
decision-making	consultancy
intelligent automation	consultancy
global assurance innovation leader	consultancy
function	consultancy
bias	consultancy
fields	consultancy
frontier	consultancy
pharma	consultancy
change management	consultancy
money laundering	consultancy
services	consultancy
program management	consultancy
smart city	consultancy
systems	consultancy
growth	consultancy
offshoring	consultancy
regulatory	consultancy
advisory risk & performance improvement	consultancy
hierarchies	consultancy
internet of things	consultancy
ai initiatives	consultancy
logistics	consultancy
asset utilization	consultancy
data science	consultancy
erp	consultancy
ai-enabled	consultancy
automated systems	consultancy
age	consultancy
testing	consultancy
resilience	consultancy
advanced analytics	consultancy
automotive	consultancy
trustworthiness	consultancy
autonomous cars	consultancy
model	consultancy
audit services	consultancy
customers	consultancy
cyberattacks	consultancy
computing	consultancy
customer care	consultancy
recruiting	consultancy
connectivity	consultancy
enterprise	consultancy
regtech	consultancy
responsible ai	consultancy
public services	consultancy
bots	consultancy
asset managers	consultancy
tariffs	consultancy
value creation	consultancy
chain	consultancy
personalization	consultancy
customer interactions	consultancy
globalization	consultancy
human resources	consultancy
capgeminis	consultancy
digital strategy	consultancy
personal growth	consultancy
applied intelligence	consultancy
insurtech	consultancy
substitution	consultancy
economies	consultancy
automations	consultancy
distribution	consultancy
capabilities	consultancy
accounting	consultancy
interpreting	consultancy
network	consultancy
energy	consultancy
digitalization	consultancy
ey	consultancy
application programming interfaces (apis)	consultancy
it	consultancy
biopharmaceuticals r&d	consultancy
platforms	consultancy
bank	consultancy
rapid extraction transformation loading search analysis	consultancy
legal compliance	consultancy
industrial	consultancy
travel	consultancy
insurtechs	consultancy
robotic process automation (rpa)	consultancy
banking industry	consultancy
tech innovation	consultancy
iot strategy	consultancy
smart technology	consultancy
predictive analytics	consultancy
and gas	consultancy
creation	consultancy
supply chains	consultancy
industries	consultancy
board matters	consultancy
disruptive technologies	consultancy
ai capabilities	consultancy
technology	consultancy
logic of competition	consultancy
ais	consultancy
chatbot	consultancy
ai algorithms	consultancy
compliance	consultancy
analytics tools	consultancy
skills development	consultancy
repetitive tasks	consultancy
3d printing	consultancy
devops	consultancy
robots	consultancy
performance management	consultancy
training	consultancy
financial crimes	consultancy
financial	consultancy
go	consultancy
quantum computing	consultancy
corporate banking	consultancy
digital transformations	consultancy
hive	consultancy
massive data sets	consultancy
digital technology	consultancy
digital twins	consultancy
decision-making processes	consultancy
global trade	consultancy
human intelligence	consultancy
players	consultancy
demand	consultancy
ai-first enterprise	consultancy
5g	consultancy
wealth and asset management	consultancy
digitization	consultancy
gbs	consultancy
economics	consultancy
financial organizations	consultancy
socioeconomic	consultancy
insight measurement	consultancy
support functions	consultancy
data-driven insights	consultancy
outcomes-based performance	consultancy
personal touch	consultancy
artificial intelligence	consultancy
strategy room	consultancy
experience	consultancy
it infrastructure	consultancy
technological	consultancy
telecom	consultancy
claims	consultancy
ai models	consultancy
iot	consultancy
data-driven models	consultancy
profit-and-loss statement	consultancy
defense	consultancy
artificial intelligence applications	consultancy
system	consultancy
provision of	consultancy
machines	consultancy
retail	consultancy
leadership	consultancy
features	consultancy
smart machines	consultancy
tmt	consultancy
cloud	consultancy
they	consultancy
retail banks	consultancy
remediation	consultancy
talent strategy	consultancy
labor	consultancy
workflows	consultancy
financial services	consultancy
innovation	consultancy
and	consultancy
banking	consultancy
companys	consultancy
competitive dynamics	consultancy
b2b	consultancy
ai platforms	consultancy
technologies	consultancy
prevention	consultancy
process automation	consultancy
ai adopters	consultancy
long-term	consultancy
computer algorithms	consultancy
environment	consultancy
m&a	consultancy
digital disruption	consultancy
automation	consultancy
capital	consultancy
fintechs	consultancy
holistic approach	consultancy
socioeconomic impacts	consultancy
artificial intelligence (ai) technology	consultancy
future mobility	consultancy
portfolio	consultancy
real-time data analytics	consultancy
sharing of massive	consultancy
automation strategy	consultancy
open banking	consultancy
manufacturing	consultancy
response: physical	consultancy
software	consultancy
sales	consultancy
bcgs	consultancy
sap	consultancy
communication	consultancy
tv advertising space	consultancy
digital platforms	consultancy
algorithms	consultancy
customer	consultancy
cios	consultancy
business problem	consultancy
tax technology	consultancy
disruption	consultancy
robotics	consultancy
soft skills	consultancy
insurance	consultancy
agile processes	consultancy
centers	consultancy
insurers	consultancy
human interaction	consultancy
engineering	consultancy
consumer	consultancy
business transformation	consultancy
marketing	consultancy
ai technology	consultancy
downloadable resources	consultancy
digital capabilities	consultancy
cio	consultancy
real-time view	consultancy
kpis	consultancy
data infrastructure	consultancy
digital world	consultancy
cycle	consultancy
ai systems	consultancy
product simplification	consultancy
operating model	consultancy
forrester	consultancy
legacy systems	consultancy
integrated solutions	consultancy
digital channels	consultancy
ai-aware	consultancy
management	consultancy
health	consultancy
digital transformation:	consultancy
ai solutions	consultancy
ecosystems	consultancy
risk transformation	consultancy
tech	consultancy
transportation	consultancy
digital technologies	consultancy
customer experience	consultancy
boston	consultancy
c-suite	consultancy
cpg	consultancy
sensors	consultancy
behaviors	consultancy
cyber	consultancy
business logic	consultancy
disruptive	consultancy
robotic process automation	consultancy
operations	consultancy
retailers	consultancy
executive summary	consultancy
go-to-market models	consultancy
models	consultancy
biopharma	consultancy
machine learning	consultancy
medical	consultancy
portfolio management	consultancy
payments	consultancy
ai?	consultancy
approach	consultancy
competition	consultancy
collaboration	consultancy
supply	consultancy
status quo	consultancy
agile	consultancy
artificial intelligence blockchain	consultancy
brands	consultancy
it/ot security	consultancy
